------------------------------------------------------------------------------------------------------------------------------||
------------------------------------------------------------------------------------------------------------------------------||
------------------------------------------------------------------------------------------------------------------------------||
------------------------------------------------------------------------------------------------------------------------------||
------------------------------------------------------------------------------------------------------------------------------||
------------------------------------------------------------------------------------------------------------------------------||
------------------------------------------------------------------------------------------------------------------------------||
------------------------------------------------------------------------------------------------------------------------------||
------------------------------------------------------------------------------------------------------------------------------||
-----------------------------------------------------------------------------------------------------#--------------#######---||
------------------------------------------------------------------------------------------------#-----------------------------||
-------------------------------------------------------------------------------------------#----------------------------------||
--P-----------------------------------------------------------------------------------#---------------------------------------||
---------------------------------------------S-----S-----S-----S-----------------#--------------------------------------------||
---------------------SS-----SS-----SSS-------#-----#-----#-----#--------------------------------------------------------------||
##########################################################################################################--------------------||
