-------------------------------------------------------------------------------------------------------------------------------|
-------------------------------------------------------------------------------------------------------------------------------|
-------------------------------------------------------------------------------------------------------------------------------|
-------------------------------------------------------------------------------------------------------------------------------|
-------------------------------------------------------------------------------------------------------------------------------|
-------------------------------------------------------------------------------------------------------------------------------|
-------------------------------------------------------------------------------------------------------------------------------|
-----------------------------------------------------------------------------------------------------------------------------#-|
-------------------------------------------------------------------------------------------------------------------------------|
-----------------------------------------------------------------------------------------------------###--S--#--S--#--S--#----S|
------------------------------------------------------------------------------------------------#----------------------------S-|
-------------------------------------------------------------------------------------------#--------------------------------S--|
--P-----------------------------------------------------------------------------------#------------------------------------S---|
---------------------------------------------S-----S-----S-----S-----------------#----------------------------------------S----|
---------------------SS-----SS-----SSS-------#-----#-----#-----#---------------------------------------------------------S-----|
#############################################################################-SSSSSSSSSSSSSSSSSSSSSSSSSSSSSSSSSSSSSSSSSSS------|
