-------------------------------------------------------------------------------------------------------------------------------||
-------------------------------------------------------------------------------------------------------------------------------||
-------------------------------------------------------------------------------------------------------------------------------||
-------------------------------------------------------------------------------------------------------------------------------||
-------------------------------------------------------------------------------------------------------------------------------||
-------------------------------------------------------------------------------------------------------------------------------||
-------------------------------------------------------------------------------------------------------------------------------||
-------------------------------------------------------------------------------------------------------------------------------||
-------------------------------------------------------------------------------------------------------------------------------||
---------------------------------------##########-------############-----------------------------------------------------------||
------------------------------------#------------------------------------------------------------------------------------------||
--P---------------------------#-----#------------------------------------------------------------------------------------------||
------------------------#-----#-----#------------------------------------##############----------------------------------------||
#######################################----------------------------------############################-------##############-----||
-------------------------------------------------------------------------------------------------------------------------------||
-------------------------------------------------------------------------------------------------------------------------------||