------------------------------------------------------------------------------------------------------------------------------||
------------------------------------------------------------------------------------------------------------------------------||
------------------------------------------------------------------------------------------------------------------------------||
------------------------------------------------------------------------------------------------------------------------------||
------------------------------------------------------------------------------------------------------------------------------||
------------------------------------------------------------------------------------------------------------------------------||
------------------------------------------------------------------------------------------------------------------------------||
------------------------------------------------------------------------------------------------------------------------------||
------------------------------------------------------------------------------------------------------------------------------||
--------------------------------------------------------------------------------------------------------------------#######---||
------------------------------------------------------------------------------------------------------------------------------||
------------------------------------------------------------------------------------------------------------------------------||
--P---------------------------------------------------------------------------------------------------------------------------||
------------------------------------------------------------------------------------------------------------------------------||
----------SS--------SSS--------SSS-----------#-----#-----#-----#-----#--------------------------------------------------------||
##########################################################################################################--------------------||
