-------------------------------------------------------------------------------------------------------------------------------
-------------------------------------------------------------------------------------------------------------------------------
-------------------------------------------------------------------------------------------------------------------------------
-------------------------------------------------------------------------------------------------------------------------------
-------------------------------------------------------------------------------------------------------------------------------
-------------------------------------------------------------------------------------------------------------------------------
-------------------------------------------------------------------------------------------------------------------------------
-------------------------------------------------------------------------------------------------------------------------------
-------------------------------------------------------------------------------------------------------------------------------
---------------------------------------##########-------############-----------------------------------------------------------
------------------------------------#------------------------------------------------------------------------------------------
--P---------------------------#-----#------------------------------------------------------------------------------------------
------------------------#-----#-----#------------------------------------##############----------------------------------------
#######################################----------------------------------############################-------##############-----
-------------------------------------------------------------------------------------------------------------------------------
-------------------------------------------------------------------------------------------------------------------------------