-----------------------------||
-----------------------------||
-----------------------------||
-----------------------------||
-----------------------------||
-----------------------------||
-----------------------------||
-----------------------------||
-----------------------------||
-----------------------------||
-----------------------------||
--P--------------------------||
------------------------#----||
#############################||
-----------------------------||
-----------------------------||