-----------------------------||
-----------------------------||
-----------------------------||
-----------------------------||
-----------------------------||
-----------------------------||
-----------------------------||
-----------------------------||
-----------------------------||
-----------------------------||
-----------------------------||
--P--------------------------||
-------------S----------#----||
#############################||
-----------------------------||
-----------------------------||